######################
#......TTTT...T.TT..T#
#########.############
#...TTT.TT...........#
#....................#
#.##################.#
#....................#
#....................#
#....................#
######################
